en	ru
tréluyer	трелуйе
ōkuchi	оокути
odoi	одои
sokhibov	сохибов
terashita	тэрасита
bjarnason	бьярнасон
koschewnikow	кожевников
fichman	фичмен
thrasyllus	фрасилл
irénée	ирене
addicks	аддикс
gossard	госсард
figueres	фигерес
josephat	джозефат
rahela	рахела
corda	корда
hrašnová	грашнова
tokyo	куроки
taruki	таруки
cailliaud	кайо
magiso	магисо
veltman	велтман
lazzell	лейзел
pankratevich	панкратьевич
miyaura	мияура
faludy	фалуди
mccafferty	маккафферти
tanamura	танамура
thapa	тхапа
spel	спел
fortia	фортия
dachauer	дахауэр
noher	ноер
koerner	кернер
gasquet	гаскей
abenza	абенса
mareen	марен
vignanelli	виньянелли
thienchai	тхиенчай
genison	пьячентини
kienzl	кинцль
usov	усов
bidou	биду
spatola	рот
anca	анка
rantasalmi	рантасалми
dvinin	двинин
donia	дония
komňacký	комняцкий
temperton	темпертон
lijie	лицзе
drori	дрори
tochiōyama	юки
nzingha	нзинга
oxide	оксид
paulescu	паулеску
berković	беркович
shacknasty	шэкнести
antonacci	антоначчи
d'eramo	д’эрамо
erneta	эрнета
zālīte	залите
mountain	маунтин
studniczka	студничка
salters	солтерс
tanister	танистер
payan	паян
fons	фонс
harkness	харкнесс
øen	ён
vermeulen	вермёлен
mougenot	мужено
triay	трьяй
womé	воме
paradisi	парадизи
devine	дивайн
dalla	далла
sanzogno	сандзоньо
kenzle	кензл
athaloc	аталок
mantock	манток
cribbins	криббинс
loiret	лорье
smug	смаг
dúin	дуйн
cease	сиз
kineo	кинэо
suteichi	сутэити
baliev	балиев
sollas	соллас
girschner	гиршнер
mokrousov	мокроусов
owron	оврон
fahmi	фахми
nastasen	настасен
hisahiko	хисахико
kupchak	купчак
rayer	райе
ashihara	асихара
akizane	манабэ
mukaidono	мукаидоно
boasberg	боасберг
čilić	чилич
yatsuda	яцуда
canaway	канэуэй
dilov	дилов
tonantius	тонантий
arnaudov	арнаудов
rest	рест
chazen	чейзен
delahoussaye	делахуси
ingeburg	инга
gerrit	геррит
ausino	аузино
rhodanius	родан
saberi	сабери
sokal	сокал
batiashvili	батиашвили
tverdislavich	твердиславич
asaga	асага
llopis	льопис
pohja	похья
yuzō	юдзо
kucheida	кюшеда
debrah	дебра
savickas	савицкас
skryabin	скрябин
phoenix	феникс
sayavush	сиявуш
qovsi	ковси
donutil	донутил
duocastella	дуокастелья
foyn	фойн
owari	овари
opetaia	опетайя
ammar	аммар
sixx	сикс
jobst	джобст
corvin	корвин
storgårds	стургордс
inigo	иниго
shmagunov	шмагун
gozzano	гоццано
lovetskiy	ловецкий
gaúcho	гаушо
asha	аша
bast	баст
glasspole	глэсспоул
yuen	юэнь
javicoli	явиколи
estanislau	эстанислау
kozhamberdy	кожамберды
hemert	хемерт
ciucă	чукэ
gürer	гюрер
ñamandú	наманду
gwynn	гвинн
shaquille	шакил
gualberto	гуальберто
pinera	пинера
kojō	кодзё
jaenicke	енике
fayzurakhmanovich	кадыров
fūa	фуа
jubinville	джубинвилл
tatsuharu	тацухару
pajkić	пайкич
kindahl	киндаль
lagerfelt	лагерфельт
gorbenko	горбенко
stok	сток
uneoki	унэоки
kometani	комэтани
langenus	лангенус
mbengue	мбенгуе
eilene	эйлен
kanameishi	канамэиси
korczagin	корчагин
mellan	меллан
anckarstjerna	анкаршерна
hoạt	хот
pierpaolo	пьерпаоло
hammanah	хамна
campanus	капман
renee	рене
nakae	накаэ
toyoaki	тоёаки
storti	сторти
buzolin	бузолин
omori	оомори
shahzad	шахзад
carracci	карраччи
marusarz	марусаж
udo	удо
borovko	боровко
savina	савина
l'obel	л’обель
nadiya	надежда
pelman	пельман
agshin	агшин
böcker	бёкер
šušnjara	шушняра
nolini	нолини
bardach	бардач
kalabane	калабан
okutsu	окуцу
philotheos	филофей
noritsuna	ватанабэ
buniet	бунье
kazimieras	казимерас
hirdwall	хирдвалль
atlanta	атланта
cladel	кладель
tura	тура
stader	стэдер
marni	марни
esta	эста
koulibaly	кулибали
morgen	морген
faruffini	фаруффини
milledge	милледж
nikawadori	никавадори
nakagami	накагами
laube	лаубе
faltings	фальтингс
rodziński	родзинский
stais	стаис
auston	остон
baghdadlian	багдадлян
omozusi	омозуси
alekseyevich	алексеевич
ayakura	аякура
graziani	грациани
manders	мандерс
zuiho	дзуихо
michaely	майкли
beltoise	бельтуаз
mesmer	месмер
seiko	сэико
pałkiewicz	палкевич
tsuruhachi	цурухати
rojeski	рожески
kajlich	кайлич
treadway	тредуэй
senecký	сенецкий
ichidai	итидаи
clodia	клодия
careena	карина
chabas	шабас
peñate	пеньяте
laikmaa	лайкмаа
fabisiak	фабисяк
caballero	кабальеро
shaoshi	шаоши
daniella	даниэлла
anderssen	андерсен
adolfo	адольфо
brossay	броссе
kageno	кагэно
mihaela	михаэла
bunke	бунке
bakkerud	баккеруд
troicki	троицки
fansten	фанстен
scholastique	сколастик
eraric	эрарих
nagomi	нагоми
alladi	аллади
gunning	ганнинг
birkenfeld	биркенфельд
cumbul	джумбул
nordau	нордау
tudi	туди
fortis	фортис
fankhauser	фанкхаузер
juuso	юусо
marotte	маротт
charlène	шарлен
ikuse	икусэ
craze	крейз
baldry	болдри
jurek	юрек
imre	имре
mayo	майо
bohatyrewicz	богатыревич
neos	неос
kanjiya	кандзия
gorli	горли
mozes	мозес
tauwitz	таувиц
postumius	постумий
sigfrit	зигфрит
kanehisa	канэхиса
shipton	шиптон
atlanersa	атланерса
weissenberg	вайссенберг
buschenhagen	бушенхаген
brûlons	брюлон
anacker	анакер
kambara	ариакэ
woronow	воронов
lloret	льорет
ceruti	черути
szombathy	сомбати
galich	галич
avari	авари
colin	колин
ichiroku	ивая
dohei	дохэи
gabler	габлер
lanneau	ланно
braos	браос
stines	стайнс
ahsan	ахсан
lagūna	лагуна
iihoshi	иихоси
zelarrayán	селарраян
neykova	нейкова
frotscher	фротшер
ibertsberger	ибертсбергер
nanij	наний
conversi	конверси
evgen'evich	евгеньевича
barteling	бартелинг
brandub	брандуб
handzuš	гандзуш
feuchtwangen	фейхтванген
togo	того
petrosian	петросян
ashfaq	ашфак
planté	планте
abeyie	абейе
ingelger	ингельгер
nagamiya	нагамия
razin	разин
mespelbrunn	меспельбрунн
kobiyama	кобияма
boncza	бонкза
taouil	таоуил
ibō	ибо
mirambell	мирамбель
ishdorjiin	ишдоржийн
goodwillie	гудвилли
yoshiizumi	ёсиидзуми
arbus	арбас
thomason	томасон
vonk	вонк
halloran	халлоран
neri	нери
zwintscher	цвинчер
kataharu	мацудаира
hermanus	германус
baziotes	базиотис
mikołajewski	миколаевский
lille	лилле
persoff	персофф
bryachislavitch	брячиславич
tsukimiya	цукимия
tsuyuno	цуюно
šíma	шима
notker	ноткер
moyu	мою
cirigliano	чирильяно
kakhelishvili	кахелишвили
murtaza	муртаза
vespa	веспа
trygve	трюгве
licá	лика
shigenaga	сигэнага
itagaki	итагаки
jingi	дзинги
berges	берхес
lensander	ленсандер
estrada	эстрада
stepinac	степинац
brochfael	брохвайл
nauer	ноер
stacey	стэйси
romanski	романски
morfeo	морфео
andalusi	андалуси
canes	канес
angern	ангерн
tureau	туро
eliashar	элисар
fotinsky	фотинский
rahmat	рахмат
thieu	тхьеу
ponton	понтон
butusov	юрий
d'ovidio	д'овидио
kevan	киван
kashfi	кашфи
sharmarke	шермарк
enzensberger	энценсбергер
manangoi	манангои
ehli	эхли
seibicke	зейбикке
kurumova	курумова
herterich	гертерих
dragosavac	драгосавац
kistler	кистлер
torbjörn	турбьёрн
yo	ё
birke	бирке
kanva	канва
senji	сэндзи
d'amade	амад
bracker	бракер
olimb	олимб
valberg	вальберг
jytte	ютте
thakar	тхакар
ohama	охама
ryokuyō	рёкуё
jacobsson	якобссон
teona	теона
genesis	дженезис
ovseyenko	овсеенко
pillet	пийе
kotli	котли
avşar	авшар
pioline	пьолин
keiller	кейлер
stiglitz	стиглиц
claypool	клейпул
hufeland	гуфеланд
yanehiro	янехиро
berdión	бердион
pierro	пьерро
pequeno	фими
merentitis	мерендитис
mazzolini	маццолини
moriya	мория
steinitz	стейниц
nolla	нолья
oriola	ориола
allègre	алегр
tenniel	тенниел
noël	ноэль
dobra	добра
altin	алтин
sandiford	сэндифорд
pentti	пентти
ikumi	икуми
farman	фарман
isanta	исанта
tatsuzawa	тацудзава
coudray	кудре
matsunae	мацунаэ
godtfred	готфрид
etana	этана
fagerlin	фагерлин
umid	умид
lelewel	лелевель
gorbach	горбах
castigliano	кастильяно
kiyohiko	киёхико
negga	негга
hřimalý	гржимали
bhattacharya	бхаттачария
sepe	сепе
czartoryski	чарторыйский
bratan	братан
kamikomaki	камикомаки
shimokōbe	симокобэ
vågslid	вагслид
garmou	гарму
valledor	вальедор
våge	ваге
papaiani	папаяни
aravantinos	аравантинос
pesakh	песах
volson	волсон
çakıcı	чакыджы
gizi	гизи
romaine	ромейн
chaabi	шааби
tenner	теннер
gungl	гунгль
utrio	утрио
burkenroad	бёркенроуд
usami	усами
secombe	сиком
shadows	шадоус
kashihara	касихара
elmer	элмер
greenfield	гринфилд
tīna	тина
reichow	рейчоу
māra	мара
melle	мелл
manohar	манохар
mormeck	мормек
miroğlu	мироглу
jacobini	якобини
piazza	пьяцца
egica	эгика
žilnik	жилник
d'esperance	д’эсперанс
christopherson	кристоферсон
mendinueta	мендинуэта
camp	кэмп
barrile	баррил
maracci	мараччи
katsuhira	кацухира
polesello	полезелло
søviknes	совкинес
tzanou	цану
shemshaki	шемшаки
presheva	прешева
marii	марии
mtschedlischwili	мчедлишвили
öznur	ознур
d'arcangelo	д’арканджело
ujiakira	ходзё
piacentini	де
agena	аджена
koson	охара
linkevičienė	линкявичене
oulton	аултон
reshma	решма
mulgrew	малгрю
kakinouchi	какиноти
gaylen	гэйлен
shaikh	шейх
unico	унико
calissano	калиссано
bunroku	бунроку
nöckler	нёклер
skucha	скуха
mihai	михай
hoag	хоаг
barış	барыш
oberthür	обертюр
račkauskas	рачкаускас
shigene	сигэнэ
tord	торд
basinus	басин
tolkin	толкин
oitome	ойтомэ
abienzo	абьенсо
okunaga	окунага
šambarov	шамбаров
patronik	патроник
marosi	мароши
herbert	герберт
ches	чес
sevenich	зевених
michibata	митибата
dobrowolski	добровольский
dinh	динь
inomov	иномов
cherkelov	черкелов
ishimaki	исимаки
tadayo	оокубо
szczepkowska	щепковская
hisatsuka	хисацука
jügderdemidiin	жугдэрдэмидийн
fujito	фудзито
lafitau	лафито
qissi	кисси
blew	блю
furuwa	фурува
menkin	менкин
gardelli	гарделли
vjenceslav	венцеслав
swedberg	сведберг
jinkichi	дзинкити
sugut	сугут
kinnunen	киннунен
schrank	шранк
dessen	дессен
eldredge	элдридж
leidy	лейди
kaprálová	капралова
jinli	цзиньли
fedorovskij	федоровский
bailach	байлач
maitan	майтан
solti	шолти
takatada	такатада
naval	навал
kortenaar	кортенаар
eomssi	омсси
kejsi	кейси
wiam	виам
azuma	адзума
bandaira	бандаира
fernie	ферни
bachtell	бачтелл
brumen	брумен
toko	токо
brownlie	браунли
seifū	сэифу
savvas	саввас
lubac	любак
pommier	поммье
dobó	добо
dürrenmatt	дюрренматт
eigner	айгнер
agustini	агустини
runge	рунге
scheiber	шайбер
rokudo	рокудо
boltwood	болтвуд
cunimund	кунимунд
cyprich	циприх
bonicelli	бониселли
hirowatari	хироватари
micflikier	микфликер
espírito	эшпириту
shumliansky	шумлянский
remfry	ремфри
davaa	бямбасурэн
percy	перси
sudharmono	судармоно
ruvalcaba	рувалькаба
minatoya	минатоя
impiö	импиё
shunzō	сюндзо
hashimov	гашимов
hyslop	хислоп
kononenko	кононенко
najdanovski	найдановски
vilgot	вильгот
bollée	болле
pomponazzi	помпонацци
khallal	халлал
zaleska	залеска
morochika	итами
lyvovich	львович
kyoko	кёко
dawalibi	давалиби
savile	савиль
linpeng	линьпэн
kowalke	ковальке
farkhad	фархад
parengaope	паренгаопе
hyballa	хибалла
fracci	фраччи
aldimir	алдимир
tulen	тулен
evelina	эвелина
lasry	лэсри
setsunan	сэцунан
hildgartner	хильдгартнер
sviatoslavna	владимировна
şahutoğlu	шахутоглу
kämna	кемна
aliyar	алияр
bojar	бояр
mielczarek	мельчарек
pesina	песина
abdullah	абдулла
roelants	рулантс
tirico	тирико
chouquet	шуке
jalali	джалали
malyshev	малышев
wodzińska	водзинска
lemmer	леммер
aschbach	ашбах
taubitz	таубиц
bolandier	боландиер
söläymanof	сулейманов
cobet	кобет
skudder	скаддер
jiān	цзянь
reno	рено
wsewolod	всеволод
welday	велдай
peel	пил
moondyne	мундин
bellicius	беллиций
künzer	кюнцер
gallini	галлини
kazumine	кадзуминэ
dzagnidze	дзагнидзе
phillipa	филлипа
kamorzin	каморзин
arbore	арборе
lobsang	лобсанг
galanis	галанис
guia	гия
rinat	ринат
mahsum	махсум
maskawa	маскава
dassigny	дассини
palacio	паласио
tommasini	томмазини
amann	аманн
hassanal	хассанал
henrikas	генрикас
ed	эд
wakley	уокли
bonitzer	боницер
nərmin	низами
pos	пос
villajos	вильяхос
stancheva	станчева
wek	век
albicocco	альбикокко
blagovestschensky	благовещенский
belinchon	белинчон
ikitsu	икицу
bocchino	боккино
kadonosono	кадоносоно
bessala	бессала
steude	штойде
kobad	кобад
denman	денман
tadamochi	сакаи
boehner	бейнер
campon	кампон
šťastný	штястны
mpho	мфо
ciolan	чолан
hennie	хенни
kebbel	кеббел
mintier	минтиер
alwy	альви
bjørnson	бьёрнсон
apolo	аполлон
kirillovich	кириллович
lode	лоде
fyrstenberg	фирстенберг
éluard	элюар
marbà	марба
w.h.	у.х.
diedrich	дидрих
smolenskin	смоленскин
radomski	радомский
jéan	кюне
panfilowitsch	панфилович
dierks	диркс
arrivabene	арривабене
myōgiryū	мёгирю
hyakkoku	хяккоку
kendra	кендра
heather	хезер
alomerović	аломерович
montfoort	монтфорт
borivoj	боривой
greifenstein	грейфенштейн
paleckis	палецкис
gróf	гроф
mansdorf	мансдорф
kitanokuni	китанокуни
borrás	боррас
huger	хьюджер
lewi	леви
lennon	леннон
mckell	маккелл
toyosawa	тоёсава
lessard	лессард
d'arvor	д'арвор
anpuku	ампуку
ericus	эрик
hekimoğlu	хекимоглу
onoue	оноэ
falyan	фальян
poniatowski	понятовский
davaajav	даваажав
daudel	додель
bianchi	бьянчи
appia	аппиа
karolyn	кэролин
duffin	даффин
sheput	шепут
grigonis	григонис
loche	лош
verdrengh	вердренг
schwannau	шваннау
tabrizi	табризи
losert	лозерт
malaterra	малатерра
klemet	клемет
volodarovych	володаревич
boccamazza	боккамацца
józefowicz	юзефович
yatomi	ятоми
vondell	вонделл
mirilashvili	мирилашвили
yuzuru	юдзуру
bierbichler	бирбихлер
bastin	бастин
kamihata	камихата
løkke	лёкке
gennadyevich	геннадьевич
mbo	мбо
josée	жозе
dušková	душкова
masaki	масаки
şentop	шентоп
rossum	россум
zeng	цзэн
auzias	озиас
chertoff	чертофф
sagezhi	сагэчжи
yaroshevsky	ярошевский
falemi	фалеми
aybüke	айбюке
mija	мия
azarmidokht	азармедохт
sopyýewiç	сопыевич
gauf	гауф
aviles	авилес
goldaraz	гольдарас
mcilvanney	макилвэнни
semels	симельс
ndlovu	ндлову
devolle	деволь
baebius	бебий
delfico	дельфико
ehmke	эмке
savang	саванг
blomstedt	блумстедт
oustalet	устале
lucette	люсетт
gay	гэй
khrystyna	кристина
castruccio	каструччо
sigi	зиги
bokan	бокан
turreau	тюрро
victoriano	викторьяно
kosgei	косгеи
cérésole	серезоль
wallon	валлон
shettar	шеттар
laza	лаза
laniel	ланьель
vassell	васселл
josephson	джозефсон
echavarri	эчаварри
hollweg	гольвег
hitachidake	хитатидакэ
iso	исо
lahaie	ляэ
bažík	бажик
hananofuji	хананофудзи
sachie	сатиэ
borisovič	борисович
apokins	апокин
fouzi	фаузи
aiboshi	айбоси
fevzi	февзи
yanes	янес
bueller	бюллер
togay	тогаи
ćurković	чуркович
cahn	кан
bird	бёрд
chesty	чести
joronen	йоронен
fanxi	фанси
companc	компанк
drahoňovský	драгоновский
bayros	байрос
grayce	грейси
grané	гране
hiraide	хираидэ
jingchu	цзинчу
tukhtasunov	тухтасунов
boztepe	бозтепе
argerich	аргерих
kanaida	канаида
munan	сидо
freyn	фрейн
cārvāka	локаята
kondratyev	кондратьев
arison	эрисон
winslowe	уинслоу
biwao	бивао
prendergast	прендергаст
ōzuyori	оодзуёри
nanakusa	нанакуса
rosetsu	нагасава
boštjan	боштьян
buet	бюэ
hamachika	хаматика
velle	вель
diestelmann	дистельманн
poggio	поджо
chiarini	киарини
kagetsu	кагэцу
garell	гарелл
krestiana	крестьяна
wilks	уилкс
xabier	ксабьер
elíasson	элиассон
jochen	йохен
menczel	менцель
odell	оделл
tanishige	танисигэ
kuichi	куити
donkova	донкова
dohasan	дохасан
debie	деби
máriássy	мариашши
suchodolski	суходольский
narai	нарай
clemons	клемонс
mayuri	маюри
cassegrain	кассегрен
merxmüller	мерксмюллер
rudonja	рудоня
löffler	леффлер
hamaichi	хамаити
troch	трох
pollen	поллен
ilarion	иларион
kasrils	касрилс
polster	полстер
szumowska	шумовская
vaagen	вааген
tateyama	татэяма
titchener	титченер
zentoku	дин
pianov	пьянов
pietra	пьетра
adebayor	адебайор
owchar	овчар
lehrs	лерс
montross	монтросс
evenson	эвенсон
fisk	фиск
mascoli	масколи
baumholtz	баумхольц
hadland	хэдленд
arewång	аревонг
skrzyński	скшиньский
kōshichi	косити
hănescu	ханеску
zlatičanin	златичанин
borne	борн
boros	борос
malalasekera	малаласекара
liesen	лизен
rawabdeh	равабде
notane	нотанэ
melino	мелино
n'zogbia	н’зогбия
moussinac	муссинак
nowak	новак
halík	галик
asunción	асунсьон
kitamura	китамура
sarid	сарид
mullah	мулло
gora	гора
glen	глен
chatah	шатах
nyathi	ньяти
qiangdong	лю
blanchot	бланшо
tappulus	таппул
bounds	даллен
abella	абелла
liipola	лийпола
dilakyan	дилакян
gabelentz	габеленц
sartori	сартори
álvarito	альваро
duyen	зуен
kumakiri	кумакири
togashi	тогаси
genevier	женевье
revilla	ревилья
makram	макрам
segmüller	сегмюллер
haddi	хадди
toshimori	тосимори
lanoil	ланойл
kerim	керим
allingham	аллингем
bujsaim	буджсаим
nyarko	ньярко
klein	клейн
peregrino	хуан
daza	даса
fresedo	фреседо
igelström	игельстром
habšudová	габшудова
vyshata	вышата
eskow	эскоу
introvigne	интровинье
naz	наз
sayuka	саюка
nagina	нагина
ntaryamira	нтарьямира
axnick	аксник
kanaru	канару
fursidius	фурсидий
whitmer	уитмер
eggestein	эггештайн
plancius	планциус
kohlberg	кольберг
frieda	фрида
torop	тороп
chupin	чупин
reinfuss	райнфус
campy	кэмпи
šaraba	шараба
farshchian	фаршчиян
ezergailis	эзергайлис
tarō	таро
feil	фейл
turčaninov	турчанинов
gheraldi	геральди
horner	хорнер
rumiana	румяна
kosei	косэи
yamaga	ямага
kearran	кирран
dumonceau	дюмонсо
gardell	гарделл
cipolla	чиполла
decleir	деклер
prokopis	прокопис
zabun	забун
hjort	йорт
ōyamato	ооямато
olaf	олаф
mahdi	махди
riedewald	ридевалд
petrovska	петровска
yiannakis	яннакис
edwardes	эдвардес
orgnani	орниани
saar	саар
cummins	камминс
khansa	ханса
ifeanyi	ифеаньи
gossain	госсайн
kohde	коде
collem	коллем
lienhardt	годфри
aloha	алоха
mutafian	мутафян
belmontet	бельмонте
bolko	болько
djinovic	джинович
beesley	бисли
obłój	облуй
dermond	дермонд
kassianides	кассианидис
udi	уди
alliot	аллио
dracontius	драконций
berberian	берберян
belsazar	бальтазар
riena	риэна
tagliariol	тальяриоль
auyeskhan	макатаевич
elzer	элзер
mashiho	масихо
budny	будный
sylvanie	сильвани
debraj	дебраж
gwiazdowski	гвяздовский
višća	вишча
marek	марек
e.	э.
sivenius	сивениус
yameen	ямин
lewczuk	левчук
etsuka	эцука
estévez	эстевес
aluspah	алушпа
dreher	дреер
fornalska	форнальская
krausnick	краусник
sarriés	сарриес
quico	кико
tsugitaka	цугитака
costales	косталес
schellendorf	шеллендорф
ricardi	рикарди
minoura	минора
lazarevski	лазаревски
masunoyama	томохару
bechini	бекини
boukoff	буков
siaka	сьяка
cat	кэт
binaisa	бинайса
ruffini	руффини
fokker	фоккер
farconnet	фарконне
breith	брайт
tōichi	тоити
hisatake	хисатакэ
bouët	буэ
kwaterko	кватерко
mühlstein	мюльштайн
nogawa	ногава
henrion	анрион
mcclean	макклин
chaboud	шабу
jochmann	йохман
poiteau	пуато
broome	брум
joelson	джоелсон
idota	идота
feer	фер
j.o.c.	дж.о.с.
michalik	михалик
caulfield	колфилд
marjie	марджи
tsukudani	цукудани
warrilow	уоррилоу
fahrney	фарни
ihei	ихэи
wenceslaus	венцеслаус
kantorovich	канторович
habte	хабте
rörland	рёланд
detre	детре
speransky	сперанский
kamuti	камути
homiyu	хомию
sheinberg	шейнберг
hescheles	хешелес
machiguchi	матигути
vaironis	вайронис
leger	леже
gallatin	галлатин
barniol	барниоль
weeraratne	уираратн
seshito	сэсито
membibre	мембибре
santen	сантен
evaristo	эваристо
tone	тонэ
nosson	натан
rydeberg	рюдеберг
glawogger	главоггер
bujanowski	буяновский
whiten	витен
schwarzschild	шварцшильд
mackay	маккэй
analolii	мазараки
duvet	дюве
bennigsen	беннигсен
muldaur	малдур
anor	аньор
asina	азина
derdowski	дердовский
vatia	ватия
model	модель
partha	партха
standjofski	стандджофски
munesuke	хондзё
carissimi	кариссими
beug	беуг
borona	борона
solabarrieta	солабарриета
capet	капе
remenyi	ременьи
janša	янша
annegret	аннегрет
hedengran	хеденгран
azedine	азедин
rajapaksa	раджапакса
chitoji	титодзи
gooch	гуч
urbšs	урбшс
higashiuchi	хигасиути
gozlino	гозлино
kobara	кобара
tanja	таня
volandri	воландри
soranami	соранами
persano	персано
mankiw	мэнкью
haugaard	хаугор
willemet	вийеме
zayn	дженерико
kubasch	кубаш
takehiro	такэхиро
urdabayeva	урдабаева
dashner	дэшнер
šebastián	себастиан
rauti	раути
bochenko	бошенко
rǫgnvaldr	рагнальд
sergeevna	сергеевна
konstantinou	константину
millenotti	милленотти
jōjima	дзёдзима
villalobos	вильялобос
closa	клоса
perkovac	перковац
qatr	катр
fend	фенд
laurencin	лорансен
shimoinaba	симоинаба
ohmann	оман
nikky	никки
fioretta	фиоретта
coretta	коретта
jey	джей
lozano	лосано
flamel	фламель
pami	пами
graybill	грейбилл
conwell	конвелл
wysocki	высоцкий
boniszewska	бонишевская
ćirković	чиркович
venkov	венков
krahn	кран
katsurō	кацуро
garré	гарре
kryschanowski	крыжановский
ghirlandaio	гирландайо
horikawa	хорикава
pintoff	пинтофф
dierbach	дирбах
bublík	бублик
kurše	курше
sielecki	селецкий
chromý	хроми
chirivella	чиривелья
amick	амик
daikuhara	даикухара
riechedly	ришедли
rosenkampff	розенкампф
danneel	дэннил
fumimura	кано
kazačkovski	казачковский
colbert	кольбер
anatolyevich	анатольевич
ziatdinow	зиятдинов
leer	лир
ayesta	айэста
gattsu	гатцу
forstater	форстейтер
biasini	бьязини
ceos	кеоса
fuyukawa	фуюкава
schulenburg	шуленбург
eloise	элоиза
chalana	шалана
wymark	уаймарк
czechowicz	чехович
pruñonosa	пруньоноса
muillethan	муллетан
iiri	иири
rafer	рафер
murara	мурара
boido	бойдо
lenuta	ленуца
tshibamba	чибамба
rimbaud	рембо
ragni	раньи
kyūji	кюдзи
tsuruya	цуруя
partics	партитс
back	бак
neele	нил
rielly	райли
zuzanna	зузанна
mccurdy	маккёрди
ronnie	ронни
hagura	хагура
fossum	фоссум
takuhide	такухидэ
flaño	фланьо
işık	ышик
melozzi	мелоцци
totori	тотори
ose	оосэ
laurinaitis	лауринайтис
lehnhausen	ленхаузен
schlechter	шлехтер
taniwaki	таниваки
shkadov	шкадов
audenaerde	ауденарде
cocteau	кокто
maggette	маггетти
machteld	мечтелд
rennerova	реннерова
mnguni	мнгуни
kinnie	кинни
viuda	вьюда
dié	ди
wakakura	вакакура
pennafina	пеннафина
hitoto	хитото
telek	телек
aberoh	аверо
vannozza	ванноцца
staehle	штеле
raison	резон
bachschmidt	бахшмидт
zangarini	дзангарини
ophüls	офюльс
hägg	хэгг
vieira	виейра
oktay	октай
sardá	сарда
fradique	фрадике
walter	уолтер
ughetto	угетто
kiroko	кироко
kate	кейт
ćertić	чертич
provost	прово
alou	алу
mooradian	мурадян
matveevitch	матвеевич
muqali	мухали
nezaket	назакет
soeprapto	супрапто
mulvaney	малвани
marley	марли
cambriels	камбриэль
masushima	масусима
yamahori	ямахори
falana	фалана
leontjev	леонтьев
cournoyer	курнуайе
beisel	бейсел
klapuch	клапух
wunibald	вунибальд
miralles	миральес
mursalova	мурсалова
dampf	дэмф
tremayne	тремейн
tsutaka	цутака
cajtlin	цейтлин
cabane	кабан
malil	мэлил
scafarelli	скафарелли
demiddi	демидди
iannis	янис
mafoumbi	мафумби
boudiba	будиба
bentivegna	бентивенья
nagaya	нагая
proksa	прокса
fenichel	фенихель
ansumane	ансумане
małynowśki	малыновский
apichatpong	апичатпонг
joti	джоти
crailsheim	крайльсгейм
trefil	трефил
chimitdorzhiev	чимитдоржиев
aarnes	орнес
ashitomi	аситоми
nonogami	ноногами
kulongoski	кулонгоски
santvaras	сантварас
sies	сис
fattori	фаттори
gati	гати
tarkhnishvili	тархнишвили
elís	эллис
tsu	тсу
tschanz	чанц
kiley	кили
garitagoitia	гаритагойтия
zezulkin	зезулькин
laoura	лаура
tamamura	тамамура
struys	стрейс
ghazaleh	газали
dahlqvist	дальквист
ashikawa	асикава
raphanel	рафанель
bansen	бансэн
harijs	харий
karuś	карусь
witbooi	витбоой
suad	суад
ancion	ансьон
ryuzaburo	рюдзабуро
argemiro	аржемиро
gustave	гюстав
varum	варум
takae	такаэ
kudomi	кудоми
mitsusue	ига
permuy	пермуй
isengwe	исенгве
tovan	туван
ailello	айлелло
bruijn	брюин
georgeson	джорджсон
aurelianus	аврелиан
trova	трова
maharaj	махарадж
khocholava	хочолава
hasenbosch	хазенбос
mihr	михр
kawalerowicz	кавалерович
nels	нельс
chorske	чорске
ddu	ди
gréco	греко
en'ya	такакиё
kehara	кэхара
weapons	уипонс
emori	эмори
korcan	корджан
kristofer	кристофер
aldorino	алдорино
bartolino	бартолино
kito	кито
traherne	траэрн
parid	парит
agudelo	агудело
izzet	иззет
sansbury	сансбэри
rangarde	рангарда
hüter	гютер
keauna	кеана
kléberson	клеберсон
monmouth	монмута
kushner	кушнер
masso	массо
bajević	баевич
chifuyu	тифую
hsien	сянь
shiryō	сирё
aboy	эбой
binkiewicz	бинкевич
holofcener	холофсенер
feather	юрьевич
yanatori	янатори
fugard	фугард
mervana	мервана
dozois	дозоис
akebono	акэбоно
brigh	бриг
kościałkowski	косцялковский
hultgreen	халтгрин
zi	цзы
harfouch	арфуш
gyzis	гизис
bikram	бикрам
szollás	соллаш
harster	харстер
begg	бегг
perlotti	перлотти
carpentieri	карпентьери
pawlik	павлик
papanikolaou	папаниколау
maslama	маслама
jamario	джамарио
lumet	люмет
ré	ре
filopoulou	филопулу
inia	иниа
meyler	мейлер
dukovski	дуковски
balakrishna	балакришна
quo	кво
sariyan	сариян
battión	баттион
daihi	сусуму
legagneur	леганьер
vetochkine	ветошкин
karia	кариа
wei​lian	вэйлянь
lizana	лисана
gowing	гоуинг
jue	джуе
maririn	маририн
marianela	марианелла
farafisa	фарафисат
huxley	хаксли
tishin	тишин
struan	струан
damarete	дамарета
scheumann	шойман
marcius	марций
bodin	бодин
velea	веля
koshira	косира
sobelman	собельман
tiganj	тигань
mey	мей
scaduto	скадуто
mulgan	мульган
cleef	клиф
cénac	сенак
pawar	павар
jõgi	юргенсон
njegoš	негош
wyschofsky	вишофски
stoppard	стоппард
meda	тадаси
o'donis	о’донис
akhtar	ахтар
degutytė	дягутите
jakubec	якубек
blatter	блаттер
aphibarnrat	апхибарнрат
ražanauskas	ражанаускас
setsurō	сэцуро
gadh	гад
papez	папец
zarmandukht	зармандухт
shoubin	шоубинь
tsubokura	цубокура
hariyadi	харияди
jiatun	цзятунь
kallenbach	калленбах
dovre	довре
khademalsharieh	хадемальшарьех
canaletto	каналетто
tell	телл
pinkhos	пинхас
sorin	сорин
quadri	квадри
eseverri	эсеверри
michiki	митики
sorsa	сорса
mulheron	малерон
leibniz	лейбниц
dřízhalová	држизгалова
sagalova	сагалова
whittle	уиттл
winnerstrand	виннерстранд
georgiadis	георгиадис
kharkevich	харкевич
woodfield	вудфилд
pré	пре
howarth	ховарт
dainis	дайнис
hirnhaim	гирнгайм
zaera	зара
gerasimos	герасимос
natsuzaki	нацудзаки
pekarovsky	пекаровский
katlewicz	катлевич
hockney	хокни
vaisampayana	вайшампаяна
besseghini	бессегини
pouyade	пуйяд
mouath	муат
andersson	андерссон
tokimasa	токимаса
tappatsu	таппацу
alexey	алексей
lavant	лавант
ruyken	рюкен
kanpan	кампан
gentarō	гэнтаро
abdurakhimov	абдурахимов
snuffy	снаффи
margo	марго
garner	гарнер
harutaka	харутака
tono	тоно
federman	федерман
whitehead	уайтхед
boudreau	будро
sisenna	сизенна
grolicki	гролицкий
sable	сэйбл
horszowski	хоршовский
morski	морский
katagiri	катагири
kokontei	коконтэи
ikenobo	икэнобо
hisaaki	хисааки
tensuiyama	масанори
choinan	хойнан
wibisono	вибисомо
fassio	фассио
cilinšek	цилиншек
marki	марки
madej	мадэй
bardei	бардей
polanski	полански
tapp	тапп
nippoldt	ниппольдт
rahner	ранер
lya	лия
elcock	элкок
orikasa	орикаса
tiéné	тьене
mcginnis	макгиннис
tweed	твид
henrika	хенрика
zidan	зидан
šemrinec	шемринец
rokia	рокиа
vahtang	вахтанг
shimotomai	симотомаи
hayashita	хаясита
venetiaan	венетиан
grote	гроте
maksimenko	максименко
näqi	наки
baeyer	байер
oczipka	очипка
augustinus	августин
gioli	джоли
fall	фолл
dine	дайн
evald	эвальд
setiawan	сетиаван
jimerson	джимерсон
brønsted	брёнстед
auboyneau	обойно
gianfederico	джанфедерико
binding	биндинг
spikings	спайкингс
heidegger	хайдеггер
inasaki	инасаки
kobato	кобато
constand	констанд
latif	латиф
davidge	дэвидж
karlović	карлович
massa	масса
palaye	пале
kamauf	камауф
shirono	сироно
miyakawa	миякава
zu	цу
sebert	себерт
nigh	най
keren	керен
maleczky	вилмош
martullo	мартулло
kasuri	касури
astiz	астис
garcete	гарсете
kromer	кромер
bane	бэйн
berditchev	бердичева
viewegh	вивег
luppi	луппи
ōkei	хаяси
yataka	ятака
penyak	пеньяк
graevenitz	гревениц
samuda	самуда
šmehlík	шмеглик
wietse	витсе
aliaksandra	александра
arshak	аршак
zamacona	замакона
frydman	фридман
mattioli	маттиоли
klobukova	клобукова
rhoda	рода
gwalchmai	гвалхмай
villegaignon	виллеганьон
hopkinson	хопкинсон
alcázar	алькасар
hinoshita	хиносита
bibra	бибра
stanislaus	станислав
cynk	цинк
shanola	шанола
stöcker	штёккер
caron	карон
kobernyak	коберняк
togi	тоги
shinma	симма
rooney	руни
stjernvall	шернваль
edesa	эдеса
burhan	бурхан
chuck	чак
gardoș	гардош
sim	сим
fóti	фоти
trooz	троз
santora	сантора
osbén	осбен
medan	медан
luatha	луата
vereza	вереса
shirononami	сирононами
žatkins	жаткин
lessy	лесси
gombauld	гомбо
ostrovskis	островский
yukiru	юкиру
fartuun	фартуун
hasemi	хасэми
youki	юки
neuendorff	нойендорф
toshizane	сэнгэ
sørvik	сёрвик
stuevold	стуевольд
attenberger	альтенбергер
imano	имано
lifson	лифсон
cung	кунг
spingler	шпинглер
gynge	гюнге
susham	сушам
kryszpin	кришпин
kulifai	кулифаи
prosalenti	просаленти
kagiwada	кагивада
klebold	клиболд
yorino	ёрино
takakatsu	такакацу
gossner	госснер
beichling	бейхлинген
hachirō	хатиро
nazareno	насарено
pasquesi	паскуэзи
dimitrij	дмитрий
rupinder	рапиндер
caneva	канева
suchenwirt	зухенвирт
giunta	джунта
minkoff	минкофф
cavada	кавада
milagrosa	милагроса
suriano	суриано
trubecki	трубецкой
sido	сидо
ivezić	ивезич
noctua	ноктуа
boullé	буль
klingström	клингстрём
kossinna	коссинна
slory	слори
knipphals	книппхальс
eutropia	евтропия
ichac	ишак
giannakopoulos	яннакопулос
prawitz	правиц
scherzinger	шерзингер
mizunashi	мидзунаси
kōkyū	асакура
essaïd	эссаид
tanasugarn	танасугарн
sinues	синуэс
haussman	хауссман
jarlinson	харлинсон
zaonikievskiy	заоникиевский
shiwasu	сивасу
bezan	безан
abachkina	абашкина
abhijit	абхиджит
merneptah	мернептах
blattner	блаттнер
jannero	джаннеро
d'herbois	д’эрбуа
capellen	капеллен
dabir	дабир
popow	попов
hyakuta	хякута
džajić	джаич
basche	баш
verhaert	верхарт
prescod	прескод
baranka	баранка
zama	зама
pearlman	перлман
osoryn	осорын
jodłowiec	йодловец
evangelinidis	евангелинидис
kumaş	ккумаш
bridgitte	бриджитт
pk	пк
ćurčić	чурчич
hisamoto	хисамото
asbjørnsen	асбьёрнсен
balearicus	балеарский
ahlam	ахлям
pharaoh's	дочь
kühr	кюр
buczek	бучек
jalmari	ялмари
petras	пятрас
canepa	канепа
ujiyuki	ходзё
poljak	поляк
suelves	суэльвес
papio	папий
rastner	растнер
rutter	раттер
carstensen	карстенсен
apodi	аподи
panta	панта
aidi	айди
aspinall	эспиналл
heijningen	хейниген
laud	лод
krylov	крылов
ładnowski	ладновский
juva	юва
rakhi	ракхи
antoon	антон
polienko	полиенко
cabianca	кабьянка
satow	сатов
casari	казари
masztaler	машталер
surtees	сёртис
trofimov	трофимов
jinni	джинни
tanashyan	танашян
setō	сэто
padgett	паджетт
toledano	толедано
gotthold	готхольд
ivyann	ивианн
sturridge	старридж
reiha	рэиха
chuprov	чупров
jääskeläinen	яаскеляйнен
hilligoss	хиллигосс
senanayake	сенанаяке
sospes	соспет
tino	тино
sikua	сикуа
tyrel	тайрел
ermindo	эрминдо
arcidiacono	арчидиаконоу
heinäluoma	хейнялуома
hoshiie	хосииэ
piznarski	пизнарский
rūsiņš	русиньш
talakić	талакич
stoskopff	штоскопф
cantarelli	кантарелли
ishbi	ишби
florencie	флоранси
heuckeroth	хёкерот
ariya	инокути
hakuho	хакухо
nikowitz	никовиц
kiyoichirō	киёитиро
bletschacher	блетшахер
markieff	маркифф
alten	альтен
rusescu	русеску
drăgescu	дрэджеску
nula	нула
patenaude	пэтноуд
ryokan	рёкан
rédon	редон
hoshyar	хошияр
perey	перей
pozzovivo	поццовиво
milla	милла
spector	спектор
lembe	лембе
stickler	штиклер
yaguchi	ягути
mitamura	митамура
paintal	пайнтал
blacha	блача
cashman	кэшман
korecki	корецкий
ramgoolam	рангулам
kolarov	коларов
cyia	сайа
jewsejewitsch	евсеевич
oefele	эфель
tianyou	тяньью
okusawa	окусава
förg	форг
taijo	тайо
asatenmai	асатэммаи
ibrahimpašić	ибрагимпашич
sanneh	санне
addis	эддис
asmir	асмир
gorkin	горкин
goodkind	гудкайнд
stellingwerf	стеллингверф
gibaud	жибо
westfeldt	уэстфелд
shunkov	шунков
zintel	зинтель
fahd	фахд
mongio	монхио
mcrorie	дербишир
fierek	фирек
cherkasova	черкасова
twyman	тваймен
evju	эвью
ka	ка
meritamen	меритамон
urach	урах
gustavson	густавсон
garrard	гаррард
cossiers	косье
raggi	раджи
kyary	кяри
nery	нери
tingjie	тинцзе
semans	семанс
cova	кова
santayana	сантаяна
serenelli	серенелли
hunefer	хунефер
axell	акселл
afra	аугсбургская
steegmans	стегманс
harashina	харасина
konstanty	константин
shimojū	симодзю
kestler	кестлер
tazumi	тадзуми
golberg	голберг
rumigny	рюминьи
belkadi	белькади
bakirova	бакирова
brina	брина
alangu	алангу
laurette	лоретт
sawant	савант
kasland	касланд
benjaminsen	беньяминсен
stoilov	стойлов
baberowski	баберовски
barazi	барази
vítková	виткова
duplessy	дюплесси
casiano	касьяно
zalayeta	салайета
cerrito	церрито
golovnine	головнин
muraki	мураки
bogosavac	богосавац
hiroto	хирото
vasariņš	васариньш
yoshibashi	ёсибаси
bortolami	бортолами
etxeberria	эчеберрия
meadowlark	медоуларк
shahak	шахак
ermits	эрмитс
jahoda	яхода
tautvilas	товтивил
franziskus	франц
bahebeck	баэбек
mehretu	мерету
aikyoh	айкё
o'connor	о'коннор
bhakna	бхакна
íñiguez	иньигес
teodato	теодато
jurak	юрак
dueball	дюбаль
stirum	штирум
testard	тестар
hertenstein	хертенштейн
ottorino	отторино
jisaku	дзисаку
gakuō	гакуо
cassuto	кассуто
burtsev	бурцев
vlasic	власик
umetaro	умэтаро
busemann	буземан
szermentowski	шерментовский
alizamanli	ализаманлы
corin	корин
shibaoka	сибаока
wellekens	веллекенс
eleider	элейдер
berkley	беркли
shinako	синако
yukihira	юкихира
allpress	олпресс
jachiewicz	яхевич
vynnyckyj	винницкий
humo	хумо
nađa	наджя
włodzimierz	влодзимеж
cogman	когман
aepinus	эпинус
forke	форк
holzman	хольцман
dinev	динев
lonscher	лоншер
isamar	исамар
brittingham	бритингхэм
mizumori	мидзумори
dervishi	дервиши
casady	кеседи
haji	хаджи
arrabal	аррабаль
sägebrecht	зегебрехт
olm	ольм
kotokaze	гоки
buscalioni	бускальони
reynaud	рейно
kamioooka	камиооока
stănescu	стэнеску
